11111111111111111111111111111
1C000000000000C0000C0000000E1
1M101001010101001001000000101
1P000000C00C000000M0000000001
11111111111111111111111111111