111111111111111111111111111111
1P0000000000C10001010011C11101
111C01100110011011100011011101
1000000000M0000011100010011111
110010011000011011111101001101
111001011010000000C10100011111
100110000010111000111000010111
101C00000000011010000100001001
100101000010000000000101000011
100001001011010011110000001111
1101C1010000011111100M00000C01
110100000000000M00000000000001
1000110110011001010100010000E1
111111111111111111111111111111