111111111111
100C0000C0E1
101111111111
10C0000C00P1
111111111111