111111111111111111
1E0000000C00000001
111111111111111101
100000000C00000001
101111111111111111
100000000C000000P1
111111111111111111